11111111111111111111111
10000000000000000000001
1C111111111111111111101
1C000000000000000000001
1C111111111111111111101
1C000000000000000000001
1C111111111111111111101
1E0000000000P0000000001
11111111111111111111111
11111111111111111111111
