1111111111111111111111111111111111
100000000000000C00000C000000000001
1010010100100000101001000000010101
1010010010101010001001000000010101
100000000C00C0000000000000000000C1
1000000000000NNNN0NNN0000000000001
1000000000100N00E000N0000000010001
100000000001C0N00000N0000010000001
100000C000001NNNNNNNN0000100000001
1000000000000000000000000100000001
1000000000000000000000C00000000001
1P00000000000000000010000100000001
1111111111111111111111111111111111
