1111111111111
100100C0000C1
1C00011111001
1P001100C1E01
1111111111111
