1111111111111111111
1000000000000001111
1001011111000P01111
1001000000000E01111
1001000000000001111
1000111110110L00001
11111111C1111111111